Front	JP訳	Label	説明
ambush	待ち伏せ	語源／語根	am（周り）＋[フランス] busch（森）
bountiful	豊富な	同義語	plentiful（豊富な）
inhale	吸い込む	語法	inhale deeply（深く吸い込む）【頻出】
crane	ツル	紛らわしい語	cranium（頭蓋骨）
inflame	炎症を起こす	語法	inflame tensions（緊張を高める）【準頻出】
predecessor	前任者	語源／語根	pre（前）＋[ラテン] decessor（去る）
meager	乏しい	同義語	scanty（乏しい）
alternative	代替	語法	alternative to A（Aの代替）【頻出】
tripe	くだらないもの	同義語	nonsense（ナンセンス）
prawn	エビ	紛らわしい語	spawn（産卵する）
offset	相殺する	語法	offset the impact（影響を相殺する）【準頻出】
tan	日焼け	語法	get a tan（日焼けする）【準頻出】
temperate	穏やかな	同義語	moderate（穏やかな）
outcome	結果	語法	affect the outcome（結果に影響する）【頻出】
hardy	頑丈な	同義語	robust（頑丈）
attorney	弁護士	語源／語根	at（に向かって）＋[ラテン] tornare（回す）
placate	なだめる	同義語	appease（なだめる）
sea anemone	イソギンチャク	語呂合わせ	「海の中でアネモネを見る」
homogeneous	同質の	語源／語根	homo（同）＋[ギリシャ] gene（生）
unprecedented	前例のない	語源／語根	un（無）＋[ラテン] precedent（前例）
inundate	氾濫させる	語法	inundate with requests（要求であふれる）【準頻出】
taint	汚染する	同義語	contaminate（汚染する）
octopus	タコ	紛らわしい語	opus（作品）
monopoly	独占	語源／語根	mono（一）＋[ギリシャ] poly（売る）
strain	緊張	語法	put a strain on（負担をかける）【頻出】
blackout	停電	同義語	power outage（停電）
stimulant	刺激物	語源／語根	stimulus（刺激）＋-ant（物）
mercantile	商業の	語源／語根	merc（商）＋[ラテン] -antile（関係）
unique	唯一の	同義語	singular（唯一）
utopia	理想郷	語源／語根	u（無）＋[ギリシャ] topos（場所）
built-in	組み込みの	語法	built-in feature（内蔵機能）【準頻出】
strand	立ち往生させる	語法	strand a traveler（旅行者を困らせる）【まれ】
arsenal	兵器庫	語源／語根	ars（武器）＋[アラビア] nal（場所）
insolvent	破産した	語源／語根	in（無）＋[ラテン] solvent（解決する）
decree	法令	同義語	edict（布告）
impetus	推進力	同義語	motivation（動機）
precipitate	引き起こす	語法	precipitate a crisis（危機を招く）【準頻出】
intricate	複雑な	同義語	complicated（複雑）
admonish	戒める	語法	admonish for mistakes（ミスを戒める）【準頻出】
loquacious	おしゃべりな	語源／語根	loqu（話す）＋[ラテン] -acious（多い）
conviction	信念	同義語	belief（信念）
transplant	移植する	語法	transplant an organ（臓器を移植する）【頻出】
amity	友好	同義語	friendship（友情）
astronomical	天文学的な	語源／語根	astro（星）＋[ギリシャ] nomy（法則）
attrition	摩耗	同義語	erosion（浸食）
platypus	カモノハシ	紛らわしい語	octopus（タコ）
diffuse	拡散する	語法	diffuse light（光を拡散する）【準頻出】
intrinsically	本質的に	語法	intrinsically valuable（本質的に価値がある）【まれ】
attest	証明する	語法	attest to the fact（事実を証明する）【準頻出】
sanitation	衛生	同義語	hygiene（衛生）
fiscal	財政の	同義語	budgetary（予算の）
markedly	著しく	語法	marked change（著しい変化）【頻出】
expose	さらす	語法	expose to risk（リスクにさらす）【頻出】
overtime	残業	語法	work overtime（残業する）【頻出】
pasture	牧草地	同義語	meadow（草地）
plaintiff	原告	語源／語根	plaint（訴え）＋[フランス] -iff（者）
prescribe	処方する	語法	prescribe medication（薬を処方する）【頻出】
ail	苦しむ	語法	ail from illness（病気で苦しむ）【まれ】
posture	姿勢	語法	maintain a posture（姿勢を保つ）【準頻出】
verdict	評決	語源／語根	ver（真実）＋[ラテン] dict（言）
magnitude	大きさ	語法	magnitude of the problem（問題の大きさ）【頻出】
devoid	欠けている	語法	be devoid of emotion（感情が欠けている）【準頻出】
celebrated	有名な	同義語	famous（有名）
paralysis	麻痺	同義語	immobility（不動）
reputed	評判の	語法	be reputed to be（〜と評判である）【準頻出】
residue	残留物	同義語	remainder（残り）
retard	遅らせる	同義語	delay（遅らせる）
anchor	錨	同義語	mooring（係留）
pod	さや	同義語	husk（殻）
viable	実行可能な	同義語	feasible（実行可能）
remit	送金する	語法	remit payment（支払いを送金する）【準頻出】
fathom	理解する	語法	fathom the meaning（意味を理解する）【準頻出】
surge	急増	語法	surge in demand（需要の急増）【頻出】
conductive	伝導性の	語法	conductive material（伝導性材料）【準頻出】
chuckle	くすくす笑う	語法	let out a chuckle（くすくす笑う）【まれ】
sprinkle	振りかける	語法	sprinkle salt（塩を振りかける）【頻出】
domain	領域	同義語	realm（領域）
unfold	展開する	語法	unfold a map（地図を展開する）【準頻出】
solemn	厳粛な	同義語	serious（真面目）
transitory	一時的な	同義語	temporary（一時的）
liaison	連絡	同義語	communication（通信）
stern	厳しい	同義語	severe（厳しい）
impede	妨げる	同義語	obstruct（妨げる）
peripheral	周辺の	同義語	marginal（周辺の）
falcon	ハヤブサ	紛らわしい語	falconry（鷹狩り）
alloy	合金	同義語	mixture（混合物）
stroll	散歩する	語法	take a stroll（散歩をする）【準頻出】
refute	反論する	語法	refute an argument（議論に反論する）【準頻出】
intestine	腸	同義語	bowel（腸）
terminology	術語	同義語	vocabulary（語彙）
singular	単数の	同義語	unique（唯一）
expire	期限切れになる	語法	expire in a year（一年で期限切れになる）【準頻出】
monotonous	単調な	同義語	repetitive（反復的）
ingenious	巧妙な	同義語	inventive（発明的）
replenish	補充する	語法	replenish supplies（供給品を補充する）【準頻出】
matrix	基盤	同義語	framework（枠組み）
coach	コーチ	同義語	trainer（トレーナー）
kidney	腎臓	同義語	nephron（腎単位）
succinct	簡潔な	同義語	concise（簡潔）
poach	密猟する	語法	poach animals（動物を密猟する）【準頻出】
collapse	崩壊する	語源／語根	col（共に）＋[ラテン] laps（滑）＋-e
inscribe	刻む	語源／語根	in（中に）＋[ラテン] scrib（書）＋-e
hectic	興奮した	語源／語根	hect（忙しい）＋-ic
suppress	抑える	語源／語根	sub（下に）＋[ラテン] press（押）＋-
tentative	仮の	同義語	同義語 provisional（暫定的な）
archipelago	群島	語源／語根	arch（主な）＋[ギリシャ] pelago（海）
cascade	滝	語源／語根	cas（落ちる）＋[ラテン] cad（落）＋-e
authoritarian	権威主義の	語源／語根	author（権威）＋[ラテン] itarian（者）
mercy	慈悲	同義語	同義語 compassion（同情）
savory	風味のある	紛らわしい語	savoury（香ばしい）
continental shelf	大陸棚	語法	continental shelf（大陸棚）【頻出】
radioactive	放射性の	語源／語根	radio（放射）＋[ラテン] active（作用）
shoddy	粗悪な	語呂合わせ	語呂合わせ 「しょぼい品、粗悪なものだ」
erode	侵食する	語源／語根	e（外に）＋[ラテン] rod（かじる）＋-e
validate	有効にする	語源／語根	val（価値）＋[ラテン] idate（する）
tactics	戦術	語源／語根	tact（触）＋[ギリシャ] ics（学）
compelling	説得力のある	同義語	同義語 convincing（説得力のある）
profusely	豊富に	同義語	同義語 abundantly（豊富に）
cursory	大まかな	語呂合わせ	語呂合わせ 「カーソルで大まかに見る」
disperse	分散する	語源／語根	dis（離れて）＋[ラテン] sperse（散らす）
overturn	覆す	語源／語根	over（上に）＋[ラテン] turn（回す）
degrade	悪化させる	語源／語根	de（下に）＋[ラテン] grade（階級）
coexistence	共存	語源／語根	co（共に）＋[ラテン] exist（存在）＋ence
whirl	ぐるぐる回る	同義語	同義語 spin（回転）
proprietor	所有者	同義語	同義語 owner（所有者）
discerning	識別力のある	語源／語根	dis（分離）＋[ラテン] cern（見る）＋-ing
masonry	石工	語呂合わせ	語呂合わせ 「迷走に石工が必要」
jolt	揺さぶる	同義語	同義語 shake（揺さぶる）
mole	ほくろ	紛らわしい語	mall（ショッピングモール）
strive	努力する	同義語	同義語 endeavor（努力する）
dispatch	派遣する	語源／語根	dis（分離）＋[ラテン] patch（縫）
discourse	論説	語源／語根	dis（離れて）＋[ラテン] course（走る）
prose	散文	同義語	同義語 narrative（物語）
expertise	専門知識	語源／語根	expert（専門家）＋[ラテン] ise（化）
smash	粉砕する	同義語	同義語 crush（粉砕）
brand	商標	同義語	同義語 trademark（商標）
appraise	評価する	語源／語根	ap（向かって）＋[ラテン] praise（価値）
upright	直立した	同義語	同義語 vertical（垂直）
withdraw	撤退する	語法	withdraw from（〜から撤退する）【頻出】
congregate	集まる	語源／語根	con（共に）＋[ラテン] greg（群れ）＋ate
allure	魅了する	語源／語根	al（〜の方へ）＋[ラテン] lure（誘惑）
equity	公平	同義語	同義語 fairness（公平）
bristle	毛が逆立つ	語呂合わせ	語呂合わせ 「ブリッと毛が逆立つ」
fierce	激しい	同義語	同義語 intense（激しい）
leverage	てこの原理	語源／語根	lever（てこ）＋[ラテン] age（作用）
articulate	明瞭に話す	語源／語根	art（技）＋[ラテン] icul（小）＋ate
cardiac	心臓の	語源／語根	cardi（心臓）＋[ギリシャ] ac（の）
conspicuous	目立つ	語源／語根	con（共に）＋[ラテン] spic（見る）＋uous
materialism	物質主義	語源／語根	material（物質）＋[ラテン] ism（主義）
absolute	絶対的な	同義語	同義語 complete（完全）
imprison	投獄する	語源／語根	im（中に）＋[ラテン] prison（牢）
satire	風刺	同義語	同義語 parody（模倣）
salvation	救済	語源／語根	salv（救う）＋[ラテン] ation（こと）
commemorate	記念する	語源／語根	com（共に）＋[ラテン] memor（記憶）＋ate
merger	合併	同義語	同義語 amalgamation（合併）
problematic	問題の多い	同義語	同義語 troublesome（厄介な）
herald	予告する	同義語	同義語 announce（発表）
dew	露	同義語	同義語 moisture（湿気）
culminate	最高潮に達する	語源／語根	culm（頂点）＋[ラテン] inate（にする）
renounce	放棄する	語源／語根	re（後ろに）＋[ラテン] nounce（告げる）
surcharge	追加料金	語源／語根	sur（上に）＋[フランス] charge（料金）
lofty	高尚な	同義語	同義語 exalted（高貴な）
dune	砂丘	語源／語根	dun（砂）＋[フランス] e
scrutinize	精査する	語源／語根	scrutin（細かく見る）＋[ラテン] ize（する）
philanthropist	慈善家	語源／語根	phil（愛）＋[ギリシャ] anthro（人）＋pist
stoop	かがむ	同義語	同義語 bend（曲げる）
symmetry	対称	語源／語根	sym（共に）＋[ギリシャ] metry（測定）
archive	記録保管所	同義語	同義語 repository（保存場所）
detain	拘留する	語源／語根	de（離れて）＋[ラテン] tain（保つ）
disk	円盤	同義語	同義語 disc（円盤）
seclusion	隔離	語源／語根	se（離れて）＋[ラテン] clusion（閉じる）
aloft	上に	同義語	同義語 above（上）
tranquil	穏やかな	同義語	同義語 peaceful（平和）
shrewd	抜け目のない	同義語	同義語 astute（鋭い）
proposition	提案	語源／語根	pro（前に）＋[ラテン] pos（置く）＋ition
incite	煽る	語源／語根	in（中に）＋[ラテン] cite（呼ぶ）
reckless	無謀な	同義語	同義語 careless（不注意）
diverge	分岐する	語源／語根	di（離れて）＋[ラテン] verge（向かう）
lethal	致命的な	同義語	同義語 deadly（致命的）
margin	余白	同義語	同義語 border（境界）
potent	強力な	同義語	同義語 powerful（強力）
aggression	攻撃性	同義語	同義語 hostility（敵意）
fringe	縁	同義語	同義語 edge（端）
assassinate	暗殺する	語源／語根	assassin（暗殺者）＋[ラテン] ate（する）
intake	摂取量	同義語	同義語 consumption（消費）
epilogue	結末	語源／語根	epi（後）＋[ギリシャ] logue（話）
composure	冷静	同義語	同義語 calmness（落ち着き）
imaginative	想像力豊かな	同義語	同義語 creative（創造的）
insane	狂気の	語源／語根	in（否定）＋[ラテン] sane（健康）
levy	課税する	語源／語根	lev（持ち上げる）＋[ラテン] y（する）
mutter	ぼそぼそ言う	同義語	同義語 murmur（つぶやく）
desperate	絶望的な	同義語	同義語 hopeless（絶望的）
magnificent	壮大な	同義語	同義語 splendid（華麗）
inventory	在庫	同義語	同義語 stock（在庫）
scavenger	清掃動物	語源／語根	scavenge（清掃）＋[ラテン] er（者）
kindle	火をつける	語源／語根	kin（火）＋[古英語] dle（する）
uprising	反乱	同義語	同義語 rebellion（反乱）
reactor	原子炉	語源／語根	re（再び）＋[ラテン] act（行為）＋or
relic	遺物	同義語	同義語 artifact（工芸品）
tundra	ツンドラ	語源／語根	tund（氷原）＋[ロシア] ra
invoke	呼び起こす	語法	invoke a feeling（感情を呼び起こす）【準頻出】
meadow	牧草地	同義語	pasture（牧場）
thrive	繁栄する	語法	thrive on（〜で栄える）【頻出】
illuminate	照らす	語源／語根	in（中に）＋[ラテン] lumin（光）＋-ate（する）
pragmatic	実用的な	紛らわしい語	practical（実際的な）
deference	敬意	語源／語根	de（離れる）＋[ラテン] fer（運ぶ）＋-ence（状態）
pupa	さなぎ	語源／語根	pu（子供）＋-pa（状態）
disclose	明らかにする	語法	disclose information（情報を明かす）【頻出】
displace	置き換える	語法	displace a person（人を追い出す）【準頻出】
ominous	不吉な	同義語	foreboding（予感）
oscillate	揺れる	語法	oscillate between A and B（AとBの間で揺れる）【まれ】
symptom	症状	紛らわしい語	syndrome（症候群）
identity	身元	語源／語根	ident（同一）＋-ity（性質）
deputy	代理	紛らわしい語	deputize（代理を務める）
imaginary	想像上の	紛らわしい語	imaginative（創造的な）
agile	機敏な	同義語	nimble（軽快な）
wither	しおれる	語呂合わせ	「ウィズで花がしおれる」
projection	見積もり	語源／語根	pro（前に）＋[ラテン] ject（投げる）＋-ion（行為）
accompaniment	伴奏	語源／語根	ac（〜に）＋[ラテン] company（仲間）＋-ment（結果）
bolster	強化する	語法	bolster confidence（自信を強める）【準頻出】
blink	まばたきする	語法	blink rapidly（速くまばたきする）【まれ】
accumulate	蓄積する	語源／語根	ac（〜に）＋[ラテン] cumul（積み重ね）＋-ate（する）
appease	なだめる	同義語	pacify（鎮める）
cruel	残酷な	同義語	brutal（残忍）
unsteady	不安定な	同義語	unstable（不安定）
premise	前提	語源／語根	pre（前に）＋[ラテン] mittere（送る）
cosmic	宇宙の	語源／語根	cosmo（宇宙）＋-ic（の）
insolent	無礼な	同義語	impudent（厚かましい）
nostalgia	郷愁	語源／語根	nost（帰る）＋algos（痛み）＋-ia（状態）
abruptly	突然	語法	abruptly stop（突然止まる）【準頻出】
invert	逆にする	語源／語根	in（中に）＋[ラテン] vert（回す）
oblique	斜めの	同義語	slanting（傾斜した）
reconcile	和解する	語法	reconcile with（〜と和解する）【頻出】
coffin	棺	同義語	casket（棺）
lucrative	利益のある	同義語	profitable（有益）
prosecution	起訴	紛らわしい語	persecution（迫害）
infrastructure	基盤構造	語源／語根	infra（下）＋[ラテン] struct（組み立て）＋-ure（状態）
submerge	水没する	語源／語根	sub（下に）＋[ラテン] merge（浸す）
dividend	配当	紛らわしい語	divisor（除数）
endorse	支持する	語法	endorse a proposal（提案を支持する）【頻出】
confine	制限する	語法	confine A to B（AをBに限定する）【頻出】
personnel	人員	紛らわしい語	personal（個人的な）
linguistics	言語学	語源／語根	lingu（言語）＋-istics（学問）
indecisive	優柔不断な	同義語	hesitant（躊躇する）
ritual	儀式	同義語	ceremony（式典）
conceive	思いつく	語法	conceive an idea（アイデアを思いつく）【準頻出】
spur	促進する	語法	spur growth（成長を促進する）【準頻出】
wrath	激怒	同義語	anger（怒り）
obliterate	消し去る	語源／語根	ob（逆らって）＋[ラテン] liter（文字）＋-ate（する）
apathy	無関心	語源／語根	a（無）＋[ギリシャ] pathy（感情）
surpass	超える	語法	surpass expectations（期待を超える）【準頻出】
realm	領域	同義語	domain（領域）
intervene	介入する	語法	intervene in（〜に介入する）【頻出】
defiance	反抗	同義語	resistance（抵抗）
frail	もろい	同義語	fragile（壊れやすい）
deliberate	故意の	紛らわしい語	deliver（届ける）
leukemia	白血病	語呂合わせ	「ルーキー、白血病で苦しむ」
feudal	封建的な	語源／語根	feud（封土）＋-al（の）
municipal	市の	同義語	civic（市民の）
meddle	干渉する	語法	meddle in（〜に干渉する）【準頻出】
monarchy	君主制	語源／語根	mono（一つ）＋archy（支配）
turbulent	騒乱の	同義語	chaotic（混沌とした）
collective	集団の	同義語	communal（共同の）
prodigal	浪費する	紛らわしい語	prodigy（天才）
outset	始まり	語法	from the outset（最初から）【頻出】
pastime	娯楽	同義語	hobby（趣味）
soot	すす	語呂合わせ	「すっとすすがつく」
brittle	もろい	同義語	fragile（壊れやすい）
paddy field	水田	語呂合わせ	「パディの田んぼ」
lucid	明快な	同義語	clear（明確）
cradle	揺りかご	紛らわしい語	curdle（凝固する）
penetrate	貫通する	語法	penetrate a barrier（障害を貫通する）【頻出】
abide	従う	語法	abide by（〜に従う）【頻出】
compliance	順守	語源／語根	com（共に）＋pli（折る）＋-ance（状態）
converge	収束する	語法	converge on（〜に収束する）【準頻出】
solicit	勧誘する	語法	solicit donations（寄付を募る）【準頻出】
livelihood	生計	同義語	subsistence（生存）
decomposer	分解者	語源／語根	de（下に）＋com（共に）＋pose（置く）＋-er（者）
tangible	具体的な	紛らわしい語	tactile（触覚の）
distrust	不信	同義語	suspicion（疑念）
empirical	経験的な	同義語	practical（実際的な）
ambivalence	両価性	語源／語根	ambi（両方）＋val（価値）＋-ence（状態）
contempt	軽蔑	同義語	disdain（嫌悪）
console	慰める	紛らわしい語	consolidate（強化する）
volatile	揮発性の	同義語	unstable（不安定）
eccentric	風変わりな	同義語	odd（奇妙）
alleviate	軽減する	語法	alleviate pain（痛みを軽減する）【準頻出】
compound	複合	語源／語根	com（共に）＋pound（置く）
abuse	虐待する	語法	abuse a child（子供を虐待する）【頻出】
credulity	軽信	語源／語根	cred（信じる）＋-ulity（性質）
elapse	経過する	語法	time elapses（時間が経過する）【準頻出】
exile	追放	語法	in exile（亡命中で）【頻出】
placebo	偽薬	語源／語根	place（置く）＋bo（〜であろう）
addiction	依存	紛らわしい語	addition（追加）
distort	歪める	語法	distort facts（事実を歪める）【準頻出】
commence	開始する	語法	commence operations（作業を開始する）【頻出】
zealot	狂信者	同義語	fanatic（狂信者）
finesse	巧妙さ	同義語	dexterity（器用さ）
numb	麻痺した	同義語	unfeeling（無感覚）
conifer	針葉樹	語源／語根	coni（円錐）＋fer（運ぶ）
tractable	従順な	同義語	obedient（従順な）
instantaneously	瞬時に	語源／語根	in（中に）＋[ラテン] stant（立つ）＋-aneous（〜のような）
stalk	忍び寄る	語法	stalk prey （獲物に忍び寄る）【準頻出】
husbandry	農業	同義語	agriculture（農業）
retrieve	取り戻す	語法	retrieve data （データを取り戻す）【準頻出】
torture	拷問	紛らわしい語	torment（苦痛）
infringe	侵害する	語源／語根	in（中に）＋[ラテン] fring（打つ）＋-e（動詞化）
momentous	重大な	同義語	significant（重要な）
incur	被る	語法	incur a penalty （罰を受ける）【頻出】
grass roots	一般大衆	語法	grass roots movement（草の根運動）【準頻出】
affliction	苦痛	同義語	suffering（苦しみ）
extort	強要する	語源／語根	ex（外に）＋[ラテン] tort（ねじる）
tame	飼いならす	紛らわしい語	lame（不十分な）
consecutive	連続した	語法	consecutive days（連続した日）【頻出】
segregation	隔離	語源／語根	se（離れて）＋[ラテン] greg（群）＋-ation（状態）
heterogeneous	異質の	語源／語根	hetero（異なる）＋[ギリシャ] gen（生まれる）＋-eous（形容）
periphery	周辺	同義語	edge（端）
insecticide	殺虫剤	語源／語根	insect（昆虫）＋[ラテン] cide（殺す）
rebellion	反乱	同義語	uprising（反乱）
pupil	生徒	紛らわしい語	puppet（操り人形）
itinerary	旅行日程	語法	itinerary plan（旅行計画）【準頻出】
infallible	絶対確実な	語源／語根	in（否定）＋[ラテン] fall（間違う）＋-ible（可能な）
blatant	露骨な	同義語	obvious（明白な）
blanket	包括的な	語法	blanket ban（全面禁止）【頻出】
rugged	険しい	同義語	rough（粗い）
notoriety	悪評	同義語	disrepute（悪評）
infer	推測する	語法	infer from context（文脈から推測する）【頻出】
subordinate	従属する	語源／語根	sub（下）＋[ラテン] ordin（順序）＋-ate（動詞化）
Neptune	海王星	紛らわしい語	nautical（航海の）
impending	差し迫った	同義語	imminent（差し迫った）
oblivion	忘却	語源／語根	ob（逆らって）＋[ラテン] livi（滑る）＋-on（状態）
innate	生まれつきの	語源／語根	in（中に）＋[ラテン] nat（生まれる）＋-e（形容）
replica	複製	同義語	copy（コピー）
formidable	手ごわい	同義語	daunting（手ごわい）
luminous	光り輝く	語源／語根	lumin（光）＋[ラテン] ous（〜に満ちた）
communal	共同の	同義語	shared（共有の）
nuisance	迷惑	同義語	annoyance（不快）
incompatible	相容れない	語源／語根	in（否定）＋[ラテン] compat（共に）＋-ible（可能な）
ascertain	確認する	語法	ascertain facts（事実を確認する）【頻出】
gale	強風	同義語	windstorm（暴風）
lateral	側面の	同義語	side（側面）
miscellaneous	雑多な	語源／語根	miscell（混ぜる）＋[ラテン] aneous（〜のような）
rubble	がれき	同義語	debris（破片）
fluorescence	蛍光	語源／語根	fluor（流れる）＋[ラテン] escence（状態）
inception	始まり	同義語	beginning（始まり）
allotment	配分	同義語	distribution（分配）
conscience	良心	同義語	morality（道徳）
render	表現する	語法	render a decision（決定を下す）【頻出】
submissive	従順な	同義語	obedient（従順な）
outright	完全な	同義語	complete（完全な）
nominal	名目上の	同義語	titular（名ばかりの）
burden	重荷	同義語	load（荷）
superb	素晴らしい	同義語	excellent（優れた）
frugal	倹約的な	同義語	economical（経済的な）
dubious	疑わしい	同義語	skeptical（懐疑的な）
cardinal	基本的な	同義語	fundamental（基本的な）
detergent	洗剤	同義語	soap（石鹸）
tacit	暗黙の	同義語	implicit（暗黙の）
mucous membrane	粘膜	同義語	mucosa（粘膜）
grim	厳しい	同義語	harsh（厳しい）
catastrophe	大災害	同義語	disaster（災害）
invoice	請求書	同義語	bill（請求書）
barely	かろうじて	同義語	scarcely（ほとんど〜ない）
ardent	熱心な	同義語	enthusiastic（熱心な）
stake	賭け金	同義語	bet（賭け）
brand-new	真新しい	同義語	fresh（新しい）
resignation	辞職	同義語	quitting（辞めること）
jargon	専門用語	同義語	terminology（用語）
tornado	竜巻	同義語	twister（竜巻）
emancipate	解放する	語源／語根	e（外に）＋[ラテン] mancip（手に持つ）＋-ate（動詞化）
adverse	逆の	同義語	contrary（反対の）
affiliate	提携する	同義語	associate（関連付ける）
simultaneous	同時の	同義語	concurrent（同時の）
supreme	最高の	同義語	highest（最上の）
quarry	採石場	同義語	pit（穴）
counterpart	対応物	同義語	equivalent（同等のもの）
pasteurization	低温殺菌	語源／語根	pasteur（パスツール）＋[ラテン] ization（動作）
hay	干し草	同義語	fodder（飼料）
unearth	発掘する	語源／語根	un（否定）＋[英] earth（土）
relevancy	関連性	同義語	connection（関連）
runoff	流出	同義語	overflow（溢れ出る）
trim	刈り込む	同義語	clip（刈る）
sodium	ナトリウム	同義語	natrium（ナトリウム）
coherent	一貫した	同義語	consistent（一貫性のある）
oppression	抑圧	同義語	repression（抑制）
enmity	敵意	同義語	hostility（敵対）
bovine	ウシの	同義語	cattle（牛）
reclaim	再生する	同義語	recover（回復する）
apathetic	無関心な	同義語	indifferent（無関心）
asymmetric	非対称の	語源／語根	a（否定）＋[ギリシャ] sym（共に）＋metr（測る）
mitigate	和らげる	同義語	relieve（軽減する）
tribute	賛辞	同義語	praise（賞賛）
esteem	尊敬	同義語	respect（尊敬）
intrude	侵入する	語法	intrude on privacy（プライバシーを侵害する）【準頻出】
scan	ざっと見る	同義語	glance（ちらりと見る）
double helix	二重らせん	同義語	twisted ladder（ねじれたはしご）
forefather	祖先	同義語	ancestor（祖先）
glossary	用語集	同義語	lexicon（辞書）
elliptical	楕円の	同義語	oval（楕円形の）
deploy	配置する	同義語	organize（組織する）
whisker	ひげ	語呂合わせ	「ウィスキー片手にひげを撫でる」
coincide	一致する	語法	coincide with（〜と一致する）【準頻出】
setback	後退	語法	suffer a setback（後退を被る）【頻出】
affirmative	肯定の	語源／語根	ad（〜へ）＋[ラテン] firm（強）＋-ative（性質）
crescent	三日月	語源／語根	cresc（増）＋-ent（もの）
eulogy	賛辞	語源／語根	eu（良）＋[ギリシャ] log（言）＋-y（名詞）
sparrow	スズメ	語呂合わせ	「スズメがスパローと鳴く」
accordingly	それに応じて	語法	act accordingly（それに応じて行動する）【頻出】
tempt	誘惑する	語法	tempt someone to do（〜するよう誘惑する）【準頻出】
inoculation	予防接種	語源／語根	in（中に）＋[ラテン] ocul（芽）＋-ation（行為）
preliminary	予備の	語源／語根	pre（前）＋[ラテン] limin（境界）＋-ary（性質）
incidental	付随的な	語法	be incidental to（〜に付随する）【準頻出】
electron microscope	電子顕微鏡	語源／語根	electr（電気）＋[ギリシャ] micro（小）＋scope（見る）
embellish	飾る	語源／語根	em（中に）＋[ラテン] bell（美）＋-ish（する）
insensitive	鈍感な	語源／語根	in（否定）＋[ラテン] sens（感）＋-itive（性質）
elusive	理解しにくい	語源／語根	e（外へ）＋[ラテン] lus（遊）＋-ive（性質）
embryonic	胚の	語源／語根	em（中に）＋[ギリシャ] bry（発芽）＋-onic（性質）
freight	貨物	語法	freight charge（貨物運賃）【準頻出】
agent	代理人	語源／語根	ag（行う）＋[ラテン] ent（人）
accuse	非難する	語法	accuse A of B（AをBで非難する）【頻出】
creditor	債権者	語源／語根	cred（信）＋[ラテン] itor（人）
exploit	搾取する	語法	exploit resources（資源を搾取する）【頻出】
candor	率直さ	語源／語根	cand（白）＋[ラテン] or（性質）
shred	細片	語法	tear into shreds（細片に裂く）【準頻出】
foresight	先見	語源／語根	fore（前）＋[英語] sight（見る）
clemency	慈悲	語源／語根	clem（穏）＋[ラテン] ency（性質）
methodical	秩序立った	語源／語根	method（方法）＋[ギリシャ] ical（性質）
rectify	修正する	語法	rectify a mistake（誤りを修正する）【準頻出】
scrape	こすり取る	語法	scrape off（こすり取る）【準頻出】
precipitous	急勾配の	語源／語根	pre（前）＋[ラテン] cipit（頭）＋-ous（多い）
animate	活気づける	語法	animate a discussion（議論を活気づける）【準頻出】
baroque	バロック様式の	語源／語根	baro（不規則）＋[スペイン] que（様式）
junk	ガラクタ	語法	junk food（ジャンクフード）【まれ】
disintegrate	崩壊する	語源／語根	dis（分離）＋[ラテン] integr（全体）＋-ate（する）
nullify	無効にする	語法	nullify a contract（契約を無効にする）【準頻出】
myriad	無数の	語源／語根	myria（無数）＋[ギリシャ] d（数量）
phonetic	音声の	語源／語根	phon（音）＋[ギリシャ] etic（性質）
accelerate	加速する	語法	accelerate growth（成長を加速する）【頻出】
consequence	結果	語法	as a consequence of（〜の結果として）【頻出】
chaotic	混沌とした	語源／語根	chaos（混沌）＋[ギリシャ] tic（性質）
meticulously	細心の注意を払って	語法	work meticulously（細心の注意を払って働く）【準頻出】
poultry	家禽	語源／語根	poul（鳥）＋[フランス] try（業）
anthropology	人類学	語源／語根	anthropo（人間）＋[ギリシャ] logy（学問）
upheaval	激変	語源／語根	up（上）＋[英語] heaval（持ち上げ）
foster	育てる	語法	foster a child（子供を育てる）【準頻出】
credibility	信頼性	語源／語根	cred（信）＋[ラテン] ibility（性質）
impair	損なう	語法	impair health（健康を損なう）【準頻出】
exoskeleton	外骨格	語源／語根	exo（外）＋[ギリシャ] skeleton（骨格）
ellipse	楕円	語源／語根	ell（他）＋[ギリシャ] ipse（形）
thrifty	倹約的な	語呂合わせ	「スリフトで倹約」
grotesque	奇怪な	語源／語根	grotto（洞窟）＋[イタリア] esque（風）
precaution	予防策	語源／語根	pre（前）＋[ラテン] caution（注意）
latent	潜在的な	語法	latent talent（潜在的な才能）【準頻出】
liner	客船	語法	ocean liner（大型客船）【準頻出】
huddle	身を寄せ合う	語法	huddle together（共に身を寄せ合う）【準頻出】
besiege	包囲する	語法	besiege a city（都市を包囲する）【準頻出】
common sense	常識	語法	lack common sense（常識を欠く）【頻出】
indiscriminate	無差別の	語法	indiscriminate attack（無差別攻撃）【準頻出】
perish	死ぬ	語法	perish in the fire（火事で死ぬ）【準頻出】
touchy	敏感な	語法	be touchy about（〜に敏感である）【準頻出】
retiring	内気な	語源／語根	re（後ろ）＋[英語] tire（引く）＋ing（性質）
peril	危険	語源／語根	per（試み）＋[ラテン] il（状態）
profusion	豊富	語源／語根	pro（前）＋[ラテン] fus（注ぐ）＋ion（名詞）
abstain	控える	語法	abstain from（〜を控える）【頻出】
preside	司会をする	語法	preside over（〜を司会する）【準頻出】
predominant	支配的な	語源／語根	pre（前）＋[ラテン] domin（支配）＋ant（性質）
bizarre	奇妙な	語源／語根	bizarr（奇）＋[フランス] e（性質）
bewilder	当惑させる	語法	bewilder someone with（〜で当惑させる）【準頻出】
deplore	嘆く	語法	deplore the loss（損失を嘆く）【準頻出】
oxidize	酸化する	語源／語根	oxid（酸素）＋[ギリシャ] ize（する）
embark	乗り出す	語法	embark on a journey（旅に乗り出す）【準頻出】
skelton	骨格	語源／語根	skel（骨）＋[ギリシャ] eton（小さい）
authenticate	認証する	語法	authenticate a document（文書を認証する）【準頻出】
futile	無益な	語法	futile attempt（無益な試み）【準頻出】
plead	嘆願する	語法	plead for mercy（慈悲を嘆願する）【準頻出】
mend	修理する	語法	mend a fence（フェンスを修理する）【準頻出】
sluggish	怠惰な	語呂合わせ	「スラッグを引いて怠ける」
spawn	産む	語法	spawn new ideas（新しいアイデアを生む）【準頻出】
indispensable	不可欠な	語法	be indispensable to（〜に不可欠である）【頻出】
yield	産出する	語法	yield results（結果を産出する）【頻出】
gum	歯茎	語法	chew gum（ガムを噛む）【準頻出】
veto	拒否権	語法	exercise a veto（拒否権を行使する）【準頻出】
contemporary	現代の	語源／語根	con（共に）＋[ラテン] tempor（時間）＋ary（性質）
psychiatrist	精神科医	語源／語根	psycho（心）＋[ギリシャ] iatrist（医者）
liability	責任	語法	liability for damages（損害賠償責任）【準頻出】
seismology	地震学	語源／語根	seismo（地震）＋[ギリシャ] logy（学問）
ordinance	条例	語源／語根	ordin（順序）＋[ラテン] ance（名詞）
herbicide	除草剤	語源／語根	herbi（草）＋[ラテン] cide（殺す）
rookery	繁殖地	語法	bird rookery（鳥の繁殖地）【準頻出】
appendix	付録	語源／語根	append（付け加える）＋[ラテン] ix（名詞）
topography	地形学	語源／語根	topo（場所）＋[ギリシャ] graphy（記述）
derive	由来する	語法	derive from（〜に由来する）【頻出】
mediate	仲介する	語法	mediate between（〜の間を仲介する）【準頻出】
coagulate	凝固する	語源／語根	co（共に）＋[ラテン] agul（集める）＋ate（する）
anonymity	匿名性	語源／語根	an（否定）＋[ギリシャ] onym（名）＋ity（性質）
unwarranted	不当な	語法	unwarranted criticism（不当な批判）【準頻出】
coniferous tree	針葉樹	語源／語根	coni（円錐）＋[ラテン] fer（運ぶ）＋ous（多い）
makeshift	間に合わせの	語法	makeshift solution（間に合わせの解決策）【準頻出】
tangle	もつれる	語法	tangle with（〜と争う）【準頻出】
taper	先細りになる	語法	taper off（次第に減少する）【準頻出】
redundant	余剰の	語源／語根	re（再び）＋[ラテン] unda（波）＋-ant
replicate	複製する	語源／語根	re（再び）＋[ラテン] plicare（折る）＋-ate
procession	行列	語源／語根	pro（前に）＋[ラテン] cedere（進む）＋-ion
celestial	天の	語源／語根	caelum（天）＋-ial
sophistication	洗練	語源／語根	sophos（賢い）＋-ication
dine	食事する	語法	【準頻出】
reservation	予約	語法	【頻出】
heredity	遺伝	語源／語根	hered（相続人）＋-ity
aberration	逸脱	語源／語根	ab（離れて）＋[ラテン] errare（さまよう）＋-ion
marital	結婚の	語源／語根	marit（結婚）＋-al
exert	（力を）発揮する	語法	【準頻出】
illusive	錯覚の	語源／語根	in（中に）＋[ラテン] ludere（遊ぶ）＋-ive
stockpile	備蓄	語法	【準頻出】
greenback	ドル紙幣	語源／語根	green（緑）＋back（背）
coercion	強制	語源／語根	co（共に）＋[ラテン] arcere（閉じ込める）＋-ion
offshore	沖の	語法	【準頻出】
lapse	失効	語源／語根	labi（滑る）＋-se
whistle	口笛を吹く	語法	【準頻出】
audit	監査	語源／語根	audire（聞く）＋-it
plenitude	豊富	語源／語根	plenus（満ちた）＋-itude
tow	牽引する	語法	【準頻出】
jurisdiction	管轄	語源／語根	juris（法）＋[ラテン] dicere（言う）＋-tion
dissident	反対者	語源／語根	di（離れて）＋[ラテン] sedere（座る）＋-ent
dismiss	解雇する	語法	【頻出】
enlightenment	啓蒙	語源／語根	en（中に）＋light（光）＋-ment
evergreen	常緑の	語法	【準頻出】
levity	軽薄	語源／語根	levis（軽い）＋-ity
wharf	埠頭	語源／語根	war（守る）＋f
virtual	仮想の	語源／語根	virtus（力）＋-al
descend	降下する	語源／語根	de（下に）＋[ラテン] scandere（登る）
outlook	見通し	語法	【頻出】
defame	中傷する	語源／語根	de（下に）＋[ラテン] fama（名声）
energize	活性化する	語法	【準頻出】
seismic	地震の	語源／語根	seismos（震え）＋-ic
authentic	本物の	語源／語根	authent（真正）＋-ic
buoy	浮かせる	語法	【準頻出】
ardor	熱意	語源／語根	ardere（燃える）＋-or
siege	包囲	語源／語根	sedere（座る）＋-ge
mirage	蜃気楼	語源／語根	mirare（驚く）＋-age
transparent	透明な	語源／語根	trans（通して）＋[ラテン] parere（現れる）＋-ent
assessment	評価	語法	【頻出】
credence	信頼	語源／語根	credere（信じる）＋-ence
flux	流動	語源／語根	fluere（流れる）＋-x
lumber	材木	語法	【準頻出】
solitary	孤独な	語源／語根	solitarius（一人の）＋-ary
hinder	妨げる	語法	【頻出】
constraint	制約	語法	【頻出】
practical	実用的な	語法	【頻出】
divergent	分岐する	語源／語根	di（離れて）＋[ラテン] vergere（曲がる）＋-ent
integrate	統合する	語法	【頻出】
anomaly	異常	語源／語根	an（なし）＋[ギリシャ] homalos（平ら）
proximity	近接	語源／語根	proximus（最も近い）＋-ity
affluence	富裕	語源／語根	ad（〜に）＋[ラテン] fluere（流れる）＋-ence
amicable	友好的な	語源／語根	amicus（友人）＋-able
repent	後悔する	語法	【準頻出】
conversion	転換	語法	【頻出】
diurnal	昼間の	語源／語根	diurnus（日中）＋-al
genetics	遺伝学	語源／語根	genesis（起源）＋-ics
ordeal	試練	語源／語根	ordal（判断）＋-de
incubate	孵化する	語法	【準頻出】
cumbersome	厄介な	語源／語根	cumber（妨げ）＋-some
adhere	付着する	語法	【頻出】
delete	削除する	語法	【頻出】
maternal	母の	語源／語根	mater（母）＋-nal
spark	火花	語源／語根	sparc（輝く）＋-k
thorax	胸郭	語源／語根	thōrax（胸）＋-x
preclude	排除する	語源／語根	pre（前に）＋[ラテン] claudere（閉じる）
exacerbate	悪化させる	語源／語根	ex（外に）＋acerbus（鋭い）＋-ate
erratic	不規則な	語源／語根	erraticus（さまよう）＋-ic
petty	些細な	語源／語根	petit（小さい）＋-y
latency period	潜伏期間	語法	【頻出】
faction	派閥	語源／語根	factio（行動）＋-ion
excerpt	抜粋	語法	【準頻出】
woe	悲哀	語源／語根	wa（悲しみ）＋-o
equivocal	曖昧な	語源／語根	equi（等しい）＋[ラテン] vocare（呼ぶ）＋-al
afflict	苦しめる	語法	【頻出】
eradicate	根絶する	語源／語根	e（外に）＋radix（根）＋-ate
despise	軽蔑する	語法	【頻出】
riverbed	川底	語法	【準頻出】
rudimentary	初歩的な	語源／語根	rudimentum（基礎）＋-ary
wilderness	荒野	語源／語根	wild（野生）＋-ness
static	静的な	語源／語根	stasis（停止）＋-tic
frontier	辺境	語法	【準頻出】
benign	良性の	語源／語根	bene（良い）＋genus（生まれ）
intermittent	断続的な	語源／語根	inter（間に）＋[ラテン] mittere（送る）＋-ent
onlooker	見物人	語法	【準頻出】
spiral	螺旋	語源／語根	spira（渦）＋-al
evasion	回避	語源／語根	evadere（逃げる）＋-ion
boost	増加させる	語法	【頻出】
remorse	後悔	語源／語根	re（再び）＋mordere（かむ）＋-se
cite	引用する	語法	【頻出】
missing	行方不明の	語法	【頻出】
oust	追い出す	語法	【頻出】
purchasing power	購買力	語法	【頻出】
manipulate	操る	語法	【頻出】
overwhelm	圧倒する	語法	【頻出】
concession	譲歩	語源／語根	con（共に）＋[ラテン] cedere（進む）＋-ion
prone	〜しがちな	語法	【頻出】
tariff	関税	語法	【頻出】
collaborate	協力する	語法	【頻出】
demystify	〜を解明する	語源／語根	de（除く）＋[ギリシャ] myst（秘）＋-ify（化）
utmost	最大限の	語源／語根	ut（外へ）＋most（最も）
itchy	かゆい	語呂合わせ	いつもかゆくてかきむしる
perspective	観点	語源／語根	per（通して）＋[ラテン] spect（見る）＋-ive（性質）
exhaustive	徹底的な	語源／語根	ex（外へ）＋haust（汲む）＋-ive（性質）
testimony	証言	語源／語根	test（証）＋[ラテン] mony（状態）
cuisine	料理	語源／語根	cuis（台所）＋-ine（の）
integral	不可欠な	語源／語根	integr（完全）＋-al（に関する）
requisite	必要な	語源／語根	re（再び）＋quis（求める）＋-ite（性質）
opportunist	日和見主義者	語源／語根	opportune（適切な）＋-ist（人）
legislation	立法	語源／語根	leg（法律）＋[ラテン] lat（運ぶ）＋-ion（状態）
congruence	一致	語源／語根	con（共に）＋gru（適する）＋-ence（状態）
grope	手探りする	語法	grope for（〜を手探りする）【頻出】
sympathy	同情	語源／語根	sym（共に）＋path（感情）＋-y（性質）
don	着用する	同義語	put on（着る）
ratify	批准する	語源／語根	rati（計算）＋-fy（化）
tantalize	じらす	語源／語根	Tantalus（神話の人物）
stipulate	〜を規定する	語法	stipulate that（〜と規定する）【頻出】
pregnant	妊娠した	語源／語根	pre（前）＋gnant（生む）
clumsy	不器用な	語呂合わせ	クラムジーな動きで不器用に見える
resonant	共鳴する	語源／語根	re（再び）＋son（音）＋-ant（性質）
controversial	議論を呼ぶ	語源／語根	contro（反対）＋vers（向く）＋-ial（に関する）
exquisite	非常に美しい	語源／語根	ex（外へ）＋quisit（探す）＋-e（もの）
avalanche	雪崩	語源／語根	aval（下降）＋anche（雪）
multitude	多数	語源／語根	multi（多く）＋-tude（状態）
preface	序文	語源／語根	pre（前）＋fac（言う）＋-e（もの）
enigma	謎	語源／語根	enig（謎）＋-ma（もの）
bureaucracy	官僚制度	語源／語根	bureau（事務）＋cracy（支配）
per capita	一人当たり	語法	per capita income（一人当たりの収入）【頻出】
orientation	適応指導	語源／語根	orient（東）＋-ation（状態）
successive	連続する	語源／語根	suc（後に）＋cess（行く）＋-ive（性質）
interim	暫定的な	語源／語根	inter（間）＋-im（状態）
averse	嫌って	語源／語根	a（反対）＋vers（向く）＋-e（性質）
subsidiary	補助的な	語源／語根	sub（下）＋sidi（座る）＋-ary（に関する）
startle	驚かせる	語法	startle A into B（Aを驚かせてBにする）【頻出】
hefty	重い	語源／語根	heft（持ち上げる）
incontrovertible	明白な	語源／語根	in（否定）＋contro（反対）＋vert（向く）＋-ible（可能）
prolific	多産の	語源／語根	pro（前に）＋lif（生）＋-ic（性質）
stereotype	固定観念	語源／語根	stereo（固い）＋type（型）
perpetual	永続的な	語源／語根	per（完全に）＋pet（求める）＋-ual（性質）
stray	迷う	語法	stray away from（〜から迷う）【頻出】
dogmatic	独断的な	語源／語根	dogma（教義）＋-tic（に関する）
embezzle	横領する	語源／語根	em（中に）＋bezzle（盗む）
statistics	統計	語源／語根	stat（立つ）＋istics（学問）
unleash	解き放つ	語法	unleash a campaign（キャンペーンを展開する）【頻出】
diligence	勤勉	語源／語根	dilig（選ぶ）＋-ence（状態）
inhibit	抑制する	語法	inhibit A from B（AをBから抑制する）【頻出】
mountain lion	ピューマ	語源／語根	mountain（山）＋lion（ライオン）
visionary	先見の明がある	語源／語根	vis（見る）＋ion（もの）＋-ary（に関する）
preponderance	優勢	語源／語根	pre（前に）＋ponder（重さ）＋-ance（状態）
canine	犬の	語源／語根	can（犬）＋-ine（に関する）
pliable	柔軟な	語源／語根	pli（曲げる）＋-able（可能）
provincial	地方の	語源／語根	provinc（州）＋-ial（に関する）
smuggle	密輸する	語源／語根	smug（密かな）＋-le（反復）
thorn	とげ	語源／語根	th（刺す）＋orn（もの）
subsidize	補助金を出す	語源／語根	sub（下）＋sid（座る）＋-ize（化）
credential	資格証明書	語源／語根	cred（信じる）＋ent（もの）＋-ial（に関する）
stagnant	停滞した	語源／語根	stag（立つ）＋-nant（状態）
disruption	混乱	語源／語根	dis（離れる）＋rupt（破る）＋-ion（状態）
token	しるし	語源／語根	tok（触れる）＋-en（もの）
induce	誘発する	語法	induce A to do（Aに〜させる）【頻出】
glimpse	ちらりと見る	語法	get a glimpse of（〜をちらりと見る）【頻出】
sanction	制裁	語源／語根	sanct（神聖）＋-ion（状態）
impulse	衝動	語源／語根	im（中に）＋puls（押す）＋-e（もの）
luminary	著名人	語源／語根	lumin（光）＋-ary（に関する）
rehabilitate	〜を回復させる	語源／語根	re（再び）＋habilit（適する）＋-ate（化）
rhetoric	修辞	語源／語根	rhetor（語る）＋-ic（学問）
gastric ulcer	胃潰瘍	語源／語根	gastric（胃の）＋ulcer（潰瘍）
equilibrium	均衡	語源／語根	equi（等しい）＋libr（平衡）＋-ium（状態）
subsequent	後の	語源／語根	sub（後）＋sequ（続く）＋-ent（性質）
underpin	支える	語源／語根	under（下）＋pin（固定する）
illusion	錯覚	語源／語根	il（中に）＋lus（遊ぶ）＋-ion（状態）
sporadic	散発的な	語源／語根	spor（種）＋-adic（性質）
founder	創設者	語源／語根	found（基礎）＋-er（人）
exemplify	〜を例証する	語法	exemplify A with B（BでAを例証する）【頻出】
idiosyncrasy	特異性	語源／語根	idio（個人）＋syn（共に）＋crasy（混合）
Uranus	天王星	語源／語根	Uranus（ギリシャ神話の神）
austere	質素な	語源／語根	aust（厳しい）＋-ere（性質）
condolence	哀悼	語源／語根	con（共に）＋dol（悲しむ）＋-ence（状態）
skeptic	懐疑論者	語源／語根	skept（見る）＋-ic（人）
ambiguous	あいまいな	語源／語根	ambi（両方）＋igu（動く）＋-ous（性質）
practitioner	開業者	語源／語根	pract（行う）＋-itioner（人）
lubricate	〜を滑らかにする	語源／語根	lubr（滑らか）＋-icate（化）
revenue	収益	語源／語根	re（再び）＋ven（来る）＋-ue（もの）
purge	〜を一掃する	語源／語根	pur（清い）＋-ge（行動）
traumatic	心的外傷の	語源／語根	trauma（傷）＋-tic（に関する）
convene	召集する	語源／語根	con（共に）＋vene（来る）
legacy	遺産	語源／語根	leg（法律）＋-acy（状態）
peer	同輩	語源／語根	peer（同等）
squall	突風	語源／語根	squ（吹く）＋all（全て）
pretentious	うぬぼれた	語源／語根	pre（前）＋tent（張る）＋-ious（性質）
obsolete	廃れた	語源／語根	ob（完全に）＋sol（慣れる）＋-ete（性質）
autonomous	自治の	語源／語根	auto（自己）＋nom（法）＋-ous（性質）
legitimate	合法の	語源／語根	legit（法律）＋-imate（に関する）
definitive	決定的な	語源／語根	de（完全に）＋finit（終わる）＋-ive（性質）
novelty	新奇さ	語源／語根	nov（新しい）＋-elty（状態）
maritime	海の	語源／語根	marit（海）＋-ime（に関する）
alert	警戒した	語法	be alert to（〜に警戒する）【頻出】
recede	後退する	語源／語根	re（後ろへ）＋cede（行く）
consequently	結果として	語源／語根	con（共に）＋sequ（続く）＋-ently（に関する）
acquire	〜を取得する	語源／語根	ad（〜の方へ）＋[ラテン]quire（求）
extravagant	贅沢な	語源／語根	extra（外へ）＋[ラテン]vagari（さまよう）
seep	漏れる	語法	seep into〜（〜に染み込む）【頻出】
glitter	輝く	同義語	sparkle（輝く）
additive	添加物	語源／語根	ad（〜の方へ）＋[ラテン]dare（与）
agenda	議題	語源／語根	agere（行う）＋-nda（こと）
intriguing	興味をそそる	語呂合わせ	「犬トリックに興味津々」
massacre	虐殺	語源／語根	mass（多く）＋[フランス]acre（殺）
censor	検閲する	語呂合わせ	「検閲で先生、さあどうする？」
outgoing	社交的な	同義語	sociable（社交的）
fortress	要塞	語源／語根	fort（強い）＋ress（場所）
gloomy	陰鬱な	同義語	dismal（陰鬱な）
concede	認める	語法	concede that〜（〜と認める）【頻出】
universala	普遍的な	語源／語根	uni（1つ）＋[ラテン]versus（向かう）
lieu	代わりに	語法	in lieu of〜（〜の代わりに）【頻出】
preeminent	卓越した	語源／語根	pre（前に）＋[ラテン]eminere（突出）
inflate	膨らませる	語源／語根	in（中に）＋[ラテン]flare（膨らます）
incomprehensible	理解不能な	語呂合わせ	「インコ、複雑すぎて理解不能」
momentum	勢い	語源／語根	movere（動く）＋-mentum（こと）
barren	不毛の	同義語	arid（不毛）
pertinent	関連する	語法	pertinent to〜（〜に関連する）【頻出】
elated	大喜びした	同義語	ecstatic（大喜び）
mob	群衆	同義語	crowd（群衆）
jellyfish	クラゲ	語源／語根	jelly（ゼリー）＋fish（魚）
havoc	大混乱	語法	play havoc with〜（〜を大混乱にする）【頻出】
eclectic	折衷的な	語源／語根	ec（外に）＋[ギリシャ]lektos（選ぶ）
obstinate	頑固な	同義語	stubborn（頑固）
standstill	停止	語法	at a standstill（停止して）【頻出】
fervor	熱情	同義語	zeal（熱情）
tuberculosis	結核	語源／語根	tuber（結節）＋culosis（病気）
incisive	鋭い	同義語	keen（鋭い）
nautical	船の	語源／語根	naut（船）＋ical（に関する）
deplete	〜を消耗させる	語法	deplete resources（資源を消耗する）【頻出】
defendant	被告	語源／語根	defend（防ぐ）＋ant（人）
improbable	ありそうもない	同義語	unlikely（ありそうもない）
decay	腐敗する	同義語	rot（腐る）
nectar	蜜	語源／語根	nek（死）＋tar（越えるもの）
concise	簡潔な	同義語	brief（簡潔）
ascendancy	優位	語源／語根	ascend（上る）＋ancy（状態）
lean	傾く	語法	lean against〜（〜に寄りかかる）【頻出】
gargle	うがいをする	語法	gargle with〜（〜でうがいする）【頻出】
abolish	廃止する	語法	abolish a law（法律を廃止する）【頻出】
devastate	〜を壊滅させる	語法	devastate an area（地域を壊滅させる）【頻出】
shudder	身震いする	語法	shudder at〜（〜に身震いする）【頻出】
illiterate	読み書きのできない	語源／語根	il（否定）＋literate（読み書きできる）
wedge	くさび	同義語	splinter（くさび）
living standard	生活水準	語法	high living standard（高い生活水準）【準頻出】
hypothetical	仮定の	語源／語根	hypo（下に）＋thetical（置かれた）
plateau	高原	語源／語根	plat（平ら）＋eau（場所）
dismal	陰鬱な	同義語	gloomy（陰鬱な）
parameter	パラメータ	語源／語根	para（横に）＋meter（測るもの）
phobia	恐怖症	語源／語根	phobos（恐怖）＋ia（病気）
posterity	後世	語源／語根	post（後）＋erity（状態）
saturate	〜を飽和させる	語法	saturate with〜（〜で飽和させる）【頻出】
compensate	補償する	語法	compensate for〜（〜を補償する）【頻出】
fanaticism	狂信	語源／語根	fanatic（狂信者）＋ism（主義）
provision	供給	語源／語根	pro（前に）＋vision（見る）
cease	〜をやめる	語法	cease to do（〜するのをやめる）【頻出】
presumption	推定	語源／語根	pre（前に）＋sumere（取る）
suffocate	窒息する	語法	suffocate in〜（〜で窒息する）【頻出】
sore	痛い	語法	sore throat（喉の痛み）【頻出】
mystical	神秘的な	同義語	spiritual（神秘的）
forbearance	忍耐	語源／語根	for（前に）＋bear（耐える）
imaginable	考えられる	語法	the worst imaginable（考えられる最悪の）【頻出】
monumental	記念碑的な	語源／語根	monument（記念碑）＋al（性質）
pueblo	プエブロ族の村	語源／語根	pueblo（村）＋[スペイン]語
haphazard	でたらめな	語源／語根	hap（偶然）＋hazard（危険）
precede	〜に先行する	語法	precede by〜（〜が先行する）【頻出】
soothe	〜を和らげる	語法	soothe a pain（痛みを和らげる）【頻出】
prompt	〜を促す	語法	prompt someone to〜（〜するよう促す）【頻出】
depict	〜を描く	語法	depict as〜（〜として描く）【頻出】
reservoir	貯水池	語源／語根	re（再び）＋servare（保存）
propriety	礼儀正しさ	語源／語根	proprius（適当）＋ity（状態）
speculate	推測する	語法	speculate about〜（〜について推測する）【頻出】
quota	割当	語源／語根	quot（どれだけ）＋a（もの）
footnote	脚注	語源／語根	foot（下）＋note（注）
outnumber	〜を数で上回る	語法	outnumber by〜（〜に数で上回る）【頻出】
curtail	〜を削減する	語法	curtail expenses（経費を削減する）【頻出】
restless	落ち着かない	語法	feel restless（落ち着かないと感じる）【頻出】
augment	〜を増加させる	語法	augment with〜（〜で増加させる）【頻出】
contingency	偶発	語法	contingency plan（非常用計画）【頻出】
benevolent	慈善的な	語源／語根	bene（良い）＋volent（望む）
scorch	〜を焦がす	語法	scorching heat（焼けつくような暑さ）【頻出】
burrow	穴を掘る	語法	burrow into〜（〜に穴を掘る）【頻出】
terminate	〜を終わらせる	語法	terminate a contract（契約を終わらせる）【頻出】
wax	ワックス	同義語	polish（ワックス）
salient	顕著な	同義語	notable（顕著）
perplex	〜を困惑させる	語法	perplex with〜（〜で困惑させる）【頻出】
provoke	〜を引き起こす	語法	provoke a reaction（反応を引き起こす）【頻出】
compatible	両立できる	語法	compatible with〜（〜と両立できる）【頻出】
divert	〜を逸らす	語法	divert attention（注意を逸らす）【頻出】
temporary	一時的な	同義語	transient（一時的）
lagoon	潟	語源／語根	lago（湖）＋oon（場所）
plague	疫病	語源／語根	plaga（打撃）＋ue（病）
elaborate	精巧な	語法	elaborate on〜（〜について詳述する）【頻出】
consolidate	〜を統合する	語法	consolidate power（権力を統合する）【頻出】
inert	不活発な	同義語	inactive（不活発）
precise	正確な	同義語	accurate（正確）
vowel	母音	語源／語根	vocare（呼ぶ）＋el（小さい）
irrelevant	無関係な	語法	irrelevant to〜（〜に無関係）【頻出】
trough	谷	紛らわしい語	紛らわしい語 tough（頑丈な）
valid	妥当な	語源／語根	val（価値）＋-id（形容詞化）
incentive	動機	語源／語根	in（中へ）＋cent（歌）＋-ive（性質）
pathetic	哀れな	語源／語根	path（感情）＋-etic（形容詞化）
growl	うなる	語呂合わせ	犬が「グルル」とうなる
expiration	満了	語源／語根	ex（外へ）＋spir（息）＋-ation（状態）
perfunctory	いい加減な	語源／語根	per（通して）＋funct（行う）＋-ory（形容詞化）
forerunner	先駆者	語源／語根	fore（前）＋run（走る）＋-er（者）
influenza	インフルエンザ	語源／語根	in（中へ）＋flu（流れる）＋-enza（病）
prevail	普及する	語源／語根	pre（前）＋vail（強い）
ascribe	〜に帰する	語法	ascribe A to B（AをBのせいにする）【頻出】
right angle	直角	語法	at a right angle（直角に）【頻出】
comply	従う	語法	comply with（〜に従う）【頻出】
enhance	高める	語源／語根	en（中に）＋hance（高く）
ponder	熟考する	語源／語根	ponder（重さ）＋-er（動詞化）
timid	臆病な	語源／語根	tim（恐れ）＋-id（形容詞化）
bill	法案	語法	pass a bill（法案を通す）【頻出】
hoist	持ち上げる	語法	hoist a flag（旗を掲げる）【頻出】
pest	害虫	語呂合わせ	ペストのように害をなす虫
obese	肥満の	語源／語根	ob（完全に）＋es（食べる）
fleet	艦隊	語呂合わせ	フリート艦隊が海を進む
manifest	明らかな	語源／語根	mani（手）＋fest（打つ）
foreshadow	予示する	語源／語根	fore（前）＋shadow（影）
menace	脅威	語法	pose a menace（脅威を与える）【頻出】
ascend	登る	語源／語根	a（向かって）＋scend（登る）
industrious	勤勉な	語呂合わせ	工場で働く姿が勤勉だ
trivial	ささいな	語源／語根	tri（３つ）＋vial（道）
furor	熱狂	語源／語根	fur（怒り）＋-or（状態）
indulge	甘やかす	語法	indulge in（〜にふける）【頻出】
capricious	気まぐれな	語源／語根	capr（ヤギ）＋-ic（形容詞化）
introvert	内向的な人	語源／語根	intro（内へ）＋vert（回る）
retract	撤回する	語源／語根	re（後ろに）＋tract（引く）
waive	放棄する	語法	waive a right（権利を放棄する）【頻出】
monetary	金銭的な	語源／語根	monet（貨幣）＋-ary（形容詞化）
concord	一致	語源／語根	con（共に）＋cord（心）
rebel	反逆者	語源／語根	re（逆らって）＋bel（戦う）
prototype	原型	語源／語根	proto（最初の）＋type（型）
finite	有限の	語源／語根	fin（終わり）＋-ite（形容詞化）
detached	分離した	語源／語根	de（離れて）＋tach（付ける）
criterion	基準	語源／語根	crit（判断）＋-ion（名詞化）
satirical	風刺的な	語源／語根	satir（詩）＋-ical（形容詞化）
bold	大胆な	語法	bold move（大胆な行動）【頻出】
compromise	妥協する	語法	reach a compromise（妥協に達する）【頻出】
hurl	投げつける	語法	hurl insults（侮辱を投げかける）【頻出】
attribute	属性	語源／語根	at（〜に）＋tribut（与える）
turbulence	乱気流	語源／語根	turb（かき乱す）＋-ulence（状態）
principal	主要な	紛らわしい語	紛らわしい語 principle（原則）
concur	同意する	語法	concur with（〜に同意する）【頻出】
install	設置する	語法	install software（ソフトをインストールする）【頻出】
erroneous	誤った	語源／語根	err（間違う）＋-oneous（形容詞化）
mandate	権限	語法	mandate to（〜への権限）【頻出】
still	静止した	語法	be still（静止している）【頻出】
rigor	厳しさ	語源／語根	rig（固い）＋-or（状態）
arduously	骨を折って	語源／語根	ard（燃える）＋-uous（形容詞化）＋-ly（副詞化）
imposing	印象的な	語源／語根	im（上に）＋pos（置く）
inertia	慣性	語源／語根	in（中へ）＋ert（動く）
texture	質感	語源／語根	text（織る）＋-ure（名詞化）
imprudent	軽率な	語源／語根	im（否定）＋prud（賢明）＋-ent（形容詞化）
perspire	汗をかく	語源／語根	per（通して）＋spir（息）＋-e（動詞化）
extol	称賛する	語源／語根	ex（外へ）＋tol（持ち上げる）
irreparable	修復不可能な	語源／語根	ir（否定）＋repar（修復）＋-able（可能）
emit	放出する	語源／語根	e（外へ）＋mit（送る）
withhold	差し控える	語法	withhold information（情報を差し控える）【頻出】
dump	投棄する	語法	dump waste（廃棄物を投棄する）【頻出】
consent	同意	語法	consent to（〜に同意する）【頻出】
renewal	更新	語源／語根	re（再び）＋new（新しい）
expedite	促進する	語源／語根	ex（外へ）＋ped（足）＋-ite（動詞化）
notorious	悪名高い	語源／語根	not（知る）＋-orious（形容詞化）
bedrock	基盤	語呂合わせ	ベッドの下の岩が基盤だ
pathology	病理学	語源／語根	path（病）＋log（学問）＋-y（名詞化）
scramble	奪い合う	語法	scramble for（〜を奪い合う）【頻出】
didactic	教訓的な	語源／語根	didact（教える）＋-ic（形容詞化）
forgo	控える	語法	forgo a pleasure（楽しみを控える）【頻出】
beset	悩ませる	語法	beset by（〜に悩まされる）【頻出】
aesthetic	美的な	語源／語根	aesthet（感覚）＋-ic（形容詞化）
susceptible	影響を受けやすい	語法	susceptible to（〜に影響を受けやすい）【頻出】
compulsion	強制	語源／語根	com（共に）＋puls（押す）＋-ion（名詞化）
spectrum	範囲	語源／語根	spect（見る）＋-rum（名詞化）
partisan	支持者	語源／語根	part（部分）＋-isan（者）
hug	抱きしめる	語呂合わせ	ハグで抱きしめる
metabolism	代謝	語源／語根	meta（変化）＋bol（投げる）＋-ism（名詞化）
frigid	極寒の	語源／語根	frig（冷たい）＋-id（形容詞化）
pervasive	広がる	語源／語根	per（通して）＋vas（行く）＋-ive（形容詞化）
retreat	撤退する	語法	retreat from（〜から撤退する）【頻出】
doom	運命づける	語源／語根	doom（運命）
apparatus	装置	語源／語根	appar（準備）＋-atus（名詞化）
erupt	噴火する	語源／語根	e（外へ）＋rupt（破裂）
arbitrary	恣意的な	語源／語根	arbitr（判断）＋-ary（形容詞化）
supplementary	補足的な	語源／語根	supplement（補う）＋-ary（形容詞化）
commitment	献身	語源／語根	com（共に）＋mit（送る）＋-ment（名詞化）
literacy	識字	語源／語根	liter（文字）＋-acy（状態）
aggravate	悪化させる	語源／語根	ag（〜の方へ）＋grav（重い）＋-ate（動詞化）
redefine	再定義する	語源／語根	re（再び）＋define（定義する）
heed	注意を払う	語法	pay heed to（〜に注意を払う）【頻出】
apprehend	逮捕する	語源／語根	ap（〜へ）＋prehend（つかむ）
roost	止まり木	語源／語根	roost（止まり木）
ignite	点火する	語源／語根	ign（火）＋-ite（動詞化）
adversary	敵	語源／語根	ad（〜に）＋vers（向く）＋-ary（者）
denounce	非難する	語源／語根	de（下に）＋nounce（述べる）
particle	粒子	語源／語根	part（部分）＋-icle（小さい）
foe	敵	紛らわしい語	紛らわしい語 faux（偽の）
abbreviate	〜を短縮する	語源／語根	ab（離れて）＋[ラテン] brevis（短い）＋-ate（する）
dilute	〜を薄める	語源／語根	di（離れて）＋[ラテン] luere（洗う）
jeopardy	危険	語源／語根	jeu（遊び）＋[フランス] parti（分ける）
linear	線形の	語源／語根	linea（線）＋[ラテン] -ar（形容詞）
counterfeit	偽造の	語源／語根	counter（反対に）＋[ラテン] facere（作る）
repertoire	レパートリー	語源／語根	re（再び）＋[フランス] partir（出発する）
proliferation	急増	語源／語根	proles（子孫）＋[ラテン] ferre（運ぶ）
fingerprint	指紋	語呂合わせ	語呂合わせ 「指にプリント」
dissolution	解散	語源／語根	dis（離れて）＋[ラテン] solvere（解く）
negligence	怠慢	語源／語根	neg（否定）＋[ラテン] legere（選ぶ）
bankruptcy	破産	語源／語根	banca（銀行）＋[イタリア] ruptus（破れる）
reminiscence	回想	語源／語根	re（再び）＋[ラテン] reminisci（思い出す）
prohibit	〜を禁止する	語源／語根	pro（前に）＋[ラテン] habere（持つ）
liquidate	〜を清算する	語源／語根	liquidus（液体の）＋[ラテン] -ate（する）
scar	傷跡	紛らわしい語	紛らわしい語 scare（怖がらせる）
diabetic	糖尿病の	語源／語根	diabetes（糖尿病）＋-ic（形容詞）
debris	がれき	語源／語根	de（離れて）＋[フランス] briser（壊す）
discriminating	識別力のある	語法	discriminating taste（識別力のある好み）【頻出】
sympathize	同情する	語源／語根	syn（共に）＋[ギリシャ] pathos（感情）
plausible	もっともらしい	語源／語根	plaudere（拍手する）＋[ラテン] -ible（できる）
ironic	皮肉な	語源／語根	eiron（皮肉）＋[ギリシャ] -ic（形容詞）
tumor	腫瘍	語源／語根	tumere（膨れる）＋[ラテン] -or（名詞）
tedious	退屈な	語呂合わせ	語呂合わせ 「手で酢をかける」
placid	穏やかな	語源／語根	placere（喜ばせる）＋[ラテン] -id（形容詞）
ethnology	民族学	語源／語根	ethnos（民族）＋[ギリシャ] -logy（学問）
acclaim	〜を称賛する	語源／語根	ad（〜に向かって）＋[ラテン] clamare（叫ぶ）
profound	深い	語源／語根	pro（前に）＋[ラテン] fundus（底）
disdain	〜を軽蔑する	語源／語根	dis（離れて）＋[ラテン] dignari（価値がある）
vigor	活力	語源／語根	vigere（活気がある）＋[ラテン] -or（名詞）
treaty	条約	語源／語根	tractare（扱う）＋[ラテン] -y（名詞）
submit	〜を提出する	語法	submit a proposal（提案を提出する）【頻出】
rebut	〜を反駁する	語源／語根	re（再び）＋[ラテン] battere（打つ）
meteorology	気象学	語源／語根	meteoron（空の物）＋[ギリシャ] -logy（学問）
fortification	要塞	語源／語根	fortis（強い）＋[ラテン] facere（作る）
discretion	裁量	語源／語根	dis（離れて）＋[ラテン] cernere（分ける）
wander	歩き回る	語呂合わせ	語呂合わせ 「ワンダーランドを歩く」
impromptu	即興の	語源／語根	in（〜の中で）＋[ラテン] promptu（用意）
contagious	伝染性の	語源／語根	con（共に）＋[ラテン] tangere（触れる）
veterinarian	獣医	語源／語根	veterinae（家畜）＋[ラテン] -arian（職業）
refurbish	〜を改装する	語源／語根	re（再び）＋[フランス] furbisher（磨く）
aggregate	総計の	語源／語根	ad（〜に向かって）＋[ラテン] gregare（集める）
elastic	弾力のある	語源／語根	elasticus（駆ける）＋[ギリシャ] -tic（形容詞）
wary	用心深い	同義語	cautious（用心深い）
judicious	賢明な	語源／語根	iudicium（判断）＋[ラテン] -ous（形容詞）
zinc	亜鉛	語呂合わせ	語呂合わせ 「ジンクで金庫」
vow	誓う	語源／語根	votum（誓い）＋[ラテン] -ar（動詞）
converse	会話する	語法	converse with（〜と会話する）【頻出】
strife	争い	語源／語根	strive（努力する）＋[古英語] -f（名詞）
remedy	治療	語法	remedy for（〜の治療）【頻出】
corrupt	腐敗する	語源／語根	cor（共に）＋[ラテン] rumpere（壊す）
memorialize	〜を記念する	語源／語根	memoria（記憶）＋[ラテン] -ize（する）
allocate	〜を割り当てる	語源／語根	ad（〜に向かって）＋[ラテン] locare（置く）
sewer	下水道	語源／語根	ex（外へ）＋[ラテン] aquarius（水の）
standpoint	観点	紛らわしい語	紛らわしい語 standpoint（立場）
paleontology	古生物学	語源／語根	paleo（古い）＋[ギリシャ] onta（存在する）
haunt	〜に出没する	語法	haunt a place（場所に出没する）【準頻出】
compile	〜を編集する	語源／語根	com（共に）＋[ラテン] pilare（集める）
uneasy	不安な	語呂合わせ	語呂合わせ 「犬、いい子で不安」
acute	鋭い	語源／語根	acutus（鋭い）＋[ラテン] -e（形容詞）
lick	〜を舐める	語呂合わせ	語呂合わせ 「リックが舐める」
censure	〜を非難する	語源／語根	censura（評価）＋[ラテン] -ure（動詞）
crude	粗野な	語源／語根	crudus（生の）＋[ラテン] -e（形容詞）
outlet	出口	語源／語根	out（外へ）＋let（小さいもの）
relief	救済	語源／語根	relieve（和らげる）＋[フランス] -ef（名詞）
acoustic	音響の	語源／語根	akouein（聞く）＋[ギリシャ] -tic（形容詞）
compel	〜を強制する	語法	compel A to do（Aに〜させる）【頻出】
hamper	〜を妨げる	紛らわしい語	紛らわしい語 hamper（かご）
nocturnal	夜行性の	語源／語根	nocturnus（夜）＋[ラテン] -al（形容詞）
amiable	愛想の良い	語源／語根	amicus（友達）＋[ラテン] -able（できる）
reserve	〜を予約する	語法	reserve a room（部屋を予約する）【頻出】
detect	〜を発見する	語源／語根	de（離れて）＋[ラテン] tegere（覆う）
abrasive	研磨剤	語源／語根	ab（離れて）＋[ラテン] radere（削る）
striking	印象的な	語呂合わせ	語呂合わせ 「ストライキが印象的」
deadlock	行き詰まり	語源／語根	dead（死）＋lock（鍵）
archetype	原型	語源／語根	archē（始まり）＋[ギリシャ] typos（型）
consensus	合意	語源／語根	con（共に）＋[ラテン] sensus（感じる）
frown	顔をしかめる	語呂合わせ	語呂合わせ 「ふらんと顔をしかめる」
blast	爆発	語源／語根	blasen（吹く）＋[ドイツ] -t（名詞）
intact	無傷の	語源／語根	in（否定）＋[ラテン] tangere（触れる）
cohesive	結束力のある	語源／語根	co（共に）＋[ラテン] haerere（くっつく）
acid	酸	語源／語根	acidus（酸っぱい）＋[ラテン] -e（名詞）
bearish	弱気の	語源／語根	bear（熊）＋-ish（形容詞）
indifferent	無関心な	語源／語根	in（否定）＋[ラテン] differre（異なる）
practicable	実行可能な	語源／語根	practicus（実践の）＋[ラテン] -able（できる）
recession	景気後退	語源／語根	re（後ろに）＋[ラテン] cedere（行く）
thatch	〜を草で葺く	語源／語根	thatch（草）＋[古英語] -e（動詞）
maneuver	〜を操作する	語源／語根	manus（手）＋[フランス] oeuvrer（働く）
antipathy	反感	語源／語根	anti（反対）＋[ギリシャ] pathos（感情）
indigestion	消化不良	語源／語根	in（否定）＋[ラテン] digestio（消化）
obsess	〜に取り憑く	語源／語根	ob（〜に対して）＋[ラテン] sedere（座る）
conclusive	決定的な	語呂合わせ	語呂合わせ 「このスリーブが決定的」
acquisition	取得	語源／語根	ad（〜に向かって）＋[ラテン] quaerere（求める）
armored	装甲の	語源／語根	armare（武装する）＋[ラテン] -ed（形容詞）
condone	〜を許す	語源／語根	con（共に）＋[ラテン] donare（与える）
captivity	捕われの身	語源／語根	captivus（捕虜）＋[ラテン] -ity（名詞）
turmoil	混乱	語源／語根	turme（混乱）＋[古英語] -il（名詞）
languish	弱る	語源／語根	languere（弱る）＋[ラテン] -ish（動詞）
uniformity	均一性	語源／語根	unus（1つ）＋[ラテン] forma（形）
patriot	愛国者	語源／語根	patri（父）＋[ギリシャ] -ot（名詞）
constituency	選挙区	語源／語根	con（共に）＋[ラテン] stitu（立）＋-ency（状態）
narrative	物語	同義語	story（物語）
embed	埋め込む	語呂合わせ	「エムベッドに石を埋め込む」
banal	陳腐な	語呂合わせ	「バナナはもう陳腐な果物」
contend	主張する	語法	contend that S V（〜と主張する）【頻出】
rigid	硬直した	同義語	inflexible（硬直した）
dissent	異議	語源／語根	dis（離れて）＋[ラテン] sent（感じる）
aloof	よそよそしい	語呂合わせ	「ある夫はよそよそしい」
divorce	離婚	語法	get a divorce（離婚する）【頻出】
critical	批判的な	語法	critical of（〜に批判的な）【頻出】
somber	重苦しい	同義語	gloomy（重苦しい）
reminiscent	思い出させる	語法	reminiscent of（〜を思い出させる）【頻出】
landfill	埋め立て地	語源／語根	land（土地）＋fill（埋める）
expel	追放する	語源／語根	ex（外へ）＋[ラテン] pel（追う）
sterilize	消毒する	語源／語根	steril（不毛）＋ize（する）
leak	漏れる	語法	leak out（漏れる）【準頻出】
apprehension	不安	語源／語根	ad（〜に向かって）＋prehend（掴む）
reclaimed land	埋立地	語法	reclaim land（土地を埋立てる）【準頻出】
disposal	処分	語法	dispose of（〜を処分する）【頻出】
mating season	繁殖期	語法	in mating season（繁殖期に）【まれ】
corrosive	腐食性の	語源／語根	cor（完全に）＋ros（かじる）＋-ive（性質）
